+---+---+---+---+---+---+---+---+---+---+---+---+---+---+---+---+
|                                                               |
+   +   +   +   +   +   +   +   +   +   +   +   +   +   +   +   +
|                                                               |
+   +   +   +   +   +   +   +   +   +   +   +   +   +   +   +   +
|                                                               |
+   +   +   +   +   +   +   +   +   +   +   +   +   +   +   +   +
|                                                               |
+   +   +   +   +   +   +   +   +   +   +   +   +   +   +   +   +
|                                                               |
+   +   +   +   +   +   +   +   +   +   +   +   +   +   +   +   +
|                                                               |
+   +   +   +   +   +   +   +   +   +   +   +   +   +   +   +   +
|                                                               |
+   +   +   +   +   +   +   +   +   +   +   +   +   +   +   +   +
|                                                               |
+---+---+---+---+---+---+---+---+   +   +   +   +   +   +   +   +
|                               |                               |
+---+---+---+---+---+---+---+   +   +   +   +   +   +   +   +   +
|   |                       |   |                               |
+   +   +---+           +---+   +   +   +   +   +   +   +   +   +
|   |   |   |               |   |                               |
+   +   +   +   +---+---+---+   +   +   +   +   +   +   +   +   +
|           |       |   |       |                               |
+   +---+---+       +   +   +   +   +   +   +   +   +   +   +   +
|           |       |   |   |   |                               |
+---+---+   +---+---+   +   +   +   +   +   +   +   +   +   +   +
|                   |   |   |   |                               |
+   +   +---+   +---+   +   +   +   +   +   +   +   +   +   +   +
|   |   |   |   |       |   |   |                               |
+   +---+   +---+   +   +   +   +   +   +   +   +   +   +   +   +
|                   |       |   |                               |
+---+---+---+---+---+---+---+---+---+---+---+---+---+---+---+---+
